-----------
-----------
--01112----
--67778----
-----------
-----------