-------------------------
---------011112----------
--011112-677778-011112---
--677778--------677778---
-------------------------
-------------------------